13
0	100	0	167	0	0	200	0	0	0	0	0	0
100	0	50	0	0	0	97	76	0	0	0	0	0
0	50	0	0	0	105	83	0	300	0	0	0	0
167	0	0	0	90	0	0	130	0	0	0	0	0
0	0	0	90	0	0	0	82	300	0	0	0	0
0	0	105	0	0	0	82	0	0	0	50	0	62
200	97	83	0	0	82	0	0	0	0	0	0	0
0	76	0	130	82	0	0	0	460	0	0	0	0
0	0	300	0	300	0	0	460	0	250	0	0	200
0	0	0	0	0	0	0	0	250	0	500	0	90
0	0	0	0	0	50	0	0	0	500	0	65	102
0	0	0	0	0	0	0	0	0	0	65	0	0
0	0	0	0	0	62	0	0	290	90	102	0	0
